"filename", "language", "Python", "XML", "JSON", "comment", "blank", "total"
"j:\PythonProg\Pygame\GrotesqueEngine\.idea\GrotesqueEngine.iml", "XML", 0, 12, 0, 0, 0, 12
"j:\PythonProg\Pygame\GrotesqueEngine\.idea\inspectionProfiles\profiles_settings.xml", "XML", 0, 6, 0, 0, 0, 6
"j:\PythonProg\Pygame\GrotesqueEngine\.idea\misc.xml", "XML", 0, 4, 0, 0, 0, 4
"j:\PythonProg\Pygame\GrotesqueEngine\.idea\modules.xml", "XML", 0, 8, 0, 0, 0, 8
"j:\PythonProg\Pygame\GrotesqueEngine\AI\FLoodFIllTest.py", "Python", 28, 0, 0, 12, 4, 44
"j:\PythonProg\Pygame\GrotesqueEngine\AI\State.py", "Python", 9, 0, 0, 0, 3, 12
"j:\PythonProg\Pygame\GrotesqueEngine\AI\States_machine.py", "Python", 18, 0, 0, 0, 5, 23
"j:\PythonProg\Pygame\GrotesqueEngine\AI\fsm_learn.py", "Python", 48, 0, 0, 0, 17, 65
"j:\PythonProg\Pygame\GrotesqueEngine\Animation\Animation.py", "Python", 92, 0, 0, 1, 31, 124
"j:\PythonProg\Pygame\GrotesqueEngine\Animation\Animation_json.py", "Python", 56, 0, 0, 4, 11, 71
"j:\PythonProg\Pygame\GrotesqueEngine\GrotesqueController.py", "Python", 1, 0, 0, 0, 0, 1
"j:\PythonProg\Pygame\GrotesqueEngine\GruesomeMapEditor\AI\NextTileFinder.py", "Python", 129, 0, 0, 18, 33, 180
"j:\PythonProg\Pygame\GrotesqueEngine\GruesomeMapEditor\AI\floodFill.py", "Python", 23, 0, 0, 0, 8, 31
"j:\PythonProg\Pygame\GrotesqueEngine\GruesomeMapEditor\ActionEditor.py", "Python", 12, 0, 0, 0, 5, 17
"j:\PythonProg\Pygame\GrotesqueEngine\GruesomeMapEditor\Data\Constant.py", "Python", 8, 0, 0, 5, 9, 22
"j:\PythonProg\Pygame\GrotesqueEngine\GruesomeMapEditor\Data\Global.py", "Python", 5, 0, 0, 0, 3, 8
"j:\PythonProg\Pygame\GrotesqueEngine\GruesomeMapEditor\Data\TileType.py", "Python", 25, 0, 0, 0, 6, 31
"j:\PythonProg\Pygame\GrotesqueEngine\GruesomeMapEditor\Deformed_map_reader.py", "Python", 97, 0, 0, 9, 33, 139
"j:\PythonProg\Pygame\GrotesqueEngine\GruesomeMapEditor\Grid.py", "Python", 16, 0, 0, 1, 8, 25
"j:\PythonProg\Pygame\GrotesqueEngine\GruesomeMapEditor\GruesomeMapMaker.py", "Python", 553, 0, 0, 71, 174, 798
"j:\PythonProg\Pygame\GrotesqueEngine\GruesomeMapEditor\Images\test.py", "Python", 16, 0, 0, 4, 2, 22
"j:\PythonProg\Pygame\GrotesqueEngine\GruesomeMapEditor\MyEncoder.py", "Python", 30, 0, 0, 6, 10, 46
"j:\PythonProg\Pygame\GrotesqueEngine\GruesomeMapEditor\Tiles.py", "Python", 101, 0, 0, 3, 25, 129
"j:\PythonProg\Pygame\GrotesqueEngine\GruesomeMapEditor\UI\Button.py", "Python", 55, 0, 0, 7, 18, 80
"j:\PythonProg\Pygame\GrotesqueEngine\GruesomeMapEditor\UI\Button_Function.py", "Python", 26, 0, 0, 5, 8, 39
"j:\PythonProg\Pygame\GrotesqueEngine\GruesomeMapEditor\UI\Explorer.py", "Python", 31, 0, 0, 5, 16, 52
"j:\PythonProg\Pygame\GrotesqueEngine\GruesomeMapEditor\UI\ScrollArea.py", "Python", 38, 0, 0, 3, 8, 49
"j:\PythonProg\Pygame\GrotesqueEngine\GruesomeMapEditor\UI\UIManager.py", "Python", 243, 0, 0, 33, 61, 337
"j:\PythonProg\Pygame\GrotesqueEngine\GruesomeMapEditor\test.json", "JSON", 0, 0, 111, 0, 0, 111
"j:\PythonProg\Pygame\GrotesqueEngine\Particles\Particles_circle.py", "Python", 49, 0, 0, 1, 19, 69
"j:\PythonProg\Pygame\GrotesqueEngine\Particles\Particles_trail.py", "Python", 83, 0, 0, 7, 26, 116
"j:\PythonProg\Pygame\GrotesqueEngine\RPJ\Character\BaseCharacter.py", "Python", 61, 0, 0, 3, 21, 85
"j:\PythonProg\Pygame\GrotesqueEngine\RPJ\Character\Player.py", "Python", 26, 0, 0, 1, 8, 35
"j:\PythonProg\Pygame\GrotesqueEngine\RPJ\Dialogue\DialiogueTest.py", "Python", 34, 0, 0, 0, 5, 39
"j:\PythonProg\Pygame\GrotesqueEngine\RPJ\Dialogue\Dialogue.py", "Python", 83, 0, 0, 21, 25, 129
"j:\PythonProg\Pygame\GrotesqueEngine\RPJ\Dialogue\Inventory.py", "Python", 7, 0, 0, 0, 2, 9
"j:\PythonProg\Pygame\GrotesqueEngine\RPJ\Grid.py", "Python", 8, 0, 0, 1, 4, 13
"j:\PythonProg\Pygame\GrotesqueEngine\houseCalculator.py", "Python", 9, 0, 0, 0, 1, 10
"j:\PythonProg\Pygame\GrotesqueEngine\test.json", "JSON", 0, 0, 87, 0, 0, 87
"j:\PythonProg\Pygame\GrotesqueEngine\test_animaton.json", "JSON", 0, 0, 181, 0, 0, 181
"Total", "-", 2020, 30, 379, 221, 609, 3259