"filename", "language", "Python", "JSON", "comment", "blank", "total"
"j:\PythonProg\Pygame\GrotesqueEngine\GruesomeMapEditor\AI\NextTileFinder.py", "Python", 129, 0, 18, 33, 180
"j:\PythonProg\Pygame\GrotesqueEngine\GruesomeMapEditor\AI\floodFill.py", "Python", 23, 0, 0, 8, 31
"j:\PythonProg\Pygame\GrotesqueEngine\GruesomeMapEditor\ActionEditor.py", "Python", 12, 0, 0, 5, 17
"j:\PythonProg\Pygame\GrotesqueEngine\GruesomeMapEditor\Data\Constant.py", "Python", 8, 0, 5, 9, 22
"j:\PythonProg\Pygame\GrotesqueEngine\GruesomeMapEditor\Data\Global.py", "Python", 5, 0, 0, 3, 8
"j:\PythonProg\Pygame\GrotesqueEngine\GruesomeMapEditor\Data\TileType.py", "Python", 25, 0, 0, 6, 31
"j:\PythonProg\Pygame\GrotesqueEngine\GruesomeMapEditor\Deformed_map_reader.py", "Python", 97, 0, 9, 33, 139
"j:\PythonProg\Pygame\GrotesqueEngine\GruesomeMapEditor\Grid.py", "Python", 16, 0, 1, 8, 25
"j:\PythonProg\Pygame\GrotesqueEngine\GruesomeMapEditor\GruesomeMapMaker.py", "Python", 553, 0, 71, 174, 798
"j:\PythonProg\Pygame\GrotesqueEngine\GruesomeMapEditor\Images\test.py", "Python", 16, 0, 4, 2, 22
"j:\PythonProg\Pygame\GrotesqueEngine\GruesomeMapEditor\MyEncoder.py", "Python", 30, 0, 6, 10, 46
"j:\PythonProg\Pygame\GrotesqueEngine\GruesomeMapEditor\Tiles.py", "Python", 101, 0, 3, 25, 129
"j:\PythonProg\Pygame\GrotesqueEngine\GruesomeMapEditor\UI\Button.py", "Python", 55, 0, 7, 18, 80
"j:\PythonProg\Pygame\GrotesqueEngine\GruesomeMapEditor\UI\Button_Function.py", "Python", 26, 0, 5, 8, 39
"j:\PythonProg\Pygame\GrotesqueEngine\GruesomeMapEditor\UI\Explorer.py", "Python", 31, 0, 5, 16, 52
"j:\PythonProg\Pygame\GrotesqueEngine\GruesomeMapEditor\UI\ScrollArea.py", "Python", 38, 0, 3, 8, 49
"j:\PythonProg\Pygame\GrotesqueEngine\GruesomeMapEditor\UI\UIManager.py", "Python", 243, 0, 33, 61, 337
"j:\PythonProg\Pygame\GrotesqueEngine\GruesomeMapEditor\test.json", "JSON", 0, 111, 0, 0, 111
"Total", "-", 1408, 111, 170, 427, 2116